0000000000000000000000000000000000000000
0000000000000000000000000000000000000000
0000000000000000000000000000000000000000
0000000000000000000000000000000000t00000
0000000000000000000000000000000000h00000
0000000000000000000000000000000000000000
0000000000000000000000000000000000000000
0000000000000000000000000000000000000000
0000000000000000000000000000000000000000
0000000000000000000000000000000000000000
000000000000################000000000000
000000000000################000000000000
000000000000################000000000000
000000000000################000000000000
000000000000################000000000000
000000000000################000000000000
000000000000################000000000000
000000000000################000000000000
000000000000################000000000000
000000000000################000000000000
0000000000000000000000000000000000000000
0000000000000000000000000000000000000000
0000000000000000000000000000000000000000
0000000000000000000000000000000000000000
0000000000000000000000000000000000000000
00000H0000000000000000000000000000000000
00000T0000000000000000000000000000000000
0000000000000000000000000000000000000000
0000000000000000000000000000000000000000
0000000000000000000000000000000000000000
