########################################
#00000000000000000000000000000000000000#
#00000000000000000000000000000000000000#
#000000000000000000000000000000000t0000#
#000000000000000000000000000000000h0000#
#00000000000000000000000000000000000000#
#00000000000000000000000000000000000000#
#00000000000000000000000000000000000000#
#00000000000000000000000000000000000000#
#00000000000000000000000000000000000000#
#00000000000################00000000000#
#00000000000################00000000000#
#00000000000################00000000000#
#00000000000################00000000000#
#00000000000################00000000000#
#00000000000################00000000000#
#00000000000################00000000000#
#00000000000################00000000000#
#00000000000################00000000000#
#00000000000################00000000000#
#00000000000000000000000000000000000000#
#00000000000000000000000000000000000000#
#00000000000000000000000000000000000000#
#00000000000000000000000000000000000000#
#00000000000000000000000000000000000000#
#0000H000000000000000000000000000000000#
#0000T000000000000000000000000000000000#
#00000000000000000000000000000000000000#
#00000000000000000000000000000000000000#
########################################
